
C 25,25,50


SO ./textures/t_gungeon_south.xpm
NO ./textures/t_gungeon_north.xpm


EA ./textures/t_gungeon_east.xpm



F 180,150,150

WE ./textures/t_gungeon_west.xpm
        1111111111111111111111111
        1000000000110000000000001
        1011000001110000000000001
        10010000000000000000W0001
111111111011000001110000000000001
10000000001100000111011111111111
11110111111111011100000010001
11110111111111011101010010001
11000000110101011100000010001
10000000000000001100000010001
10000000000000001101010010001
110000011101010111110111100111
11110111 1110101 101111010001
11111111 1111111 111111111111
