......111111111........
......100000001........
11111110000000111111...
100000000000000000E1...
10000000000000111111...
111111100000001........
......10000000111111111
......10000000000000001
......11111111100000001
..............100000001
..............111111111
