.........
...1111..
111100111
10000N001
100000001
111111011
..100001.
..101001.
..100001.
..111111.

