
C 25,25,50


SO ./textures/flame1.xpm
NO ./textures/flame1.xpm

EA ./textures/flame2.xpm

F 130,100,70

WE ./textures/flame3.xpm
        1111111111111111111111111
        1000000000110000000000001
        10110000011A0000000000001
        10010000000C0W00000000001
1111111110110000011A0000000000001
10000000001100000111C11111111111
11110111111111011100000010001
11110111111111011101010010001
11000000110101011100000010001
10000000000000001100000010001
10000000000000001101010010001
110000011101010111110111100111
11110111 1110101 101111010001
11111111 1111111 111111111111
