
C 25,25,50

D ./textures/t_gungeon_door.xpm

SO ./textures/wall.xpm
NO ./textures/flame1.xpm

EA ./textures/flame2.xpm

A3 {
./textures/flame1.xpm
./textures/flame2.xpm
./textures/flame3.xpm
}

F 130,100,70

WE ./textures/flame3.xpm
        1111111111111111111111111
        1000000000110000000000001
        10110000011A0000000000001
        10010000000D0000000W00001
1111111110110000011A0000000000001
10000000001100000111D1111DD011111
1111011111111101110000001DD001
111101111111110111010100100001
110000001101010111000000100001
100000000000000011000000100001
100000000000000011010100100001
110000011101010111110111100111
11110111 1110101 101111010001
11111111 1111111 111111111111
