
C 25,25,50


SO /nfs/homes/alprival/Cub3d/textures/wall.xpm
NO /nfs/homes/alprival/Cub3d/textures/wall.xpm

EA /nfs/homes/alprival/Cub3d/textures/wall.xpm

F 130,100,70

WE /nfs/homes/alprival/Cub3d/textures/wall.xpm
        1111111111111111111111111
        1000000000110000000000001
        10110000011A0000000000001
        10010000000D0W00000000001
1111111110110000011A0000000000001
10000000001100000111D11111111111
11110111111111011100000010001
1111D111111111011101010010001
11000000110101011100000010001
10000000000000001100000010001
100A0000000000001101010010001
110000011101010111110111100111
11110111 1110101 101111010001
1111A111 1111111 111111111111
